11111111
1P0001C1
100C0011
10000001
100C00E1
11111111
