11111111
1X000001
100C0001
10000001
100EP001
11111111
