111111111
100000001
1PCE000001
111111111
