1111111111111111111111111111111111111111111111
1000011000C0100011000C00001C00000000001000C001
101C00000000100000C000000010011110000011101111
101100000C0010C1110000000010010010C00010000001
1010000100001001C00110001000000011111110111101
10100010001P100100000000100C00000000001000C001
1010001000010000000000000000000000000010000001
101C0010000E100001111100000000000C000010010001
101100000001111011C000000000111111110010010001
1C0001001100000000000000C00010000001C00000C001
1000000011000000000000000000100000011110000001
1000C000010000000000C0011111100000000010000001
1000000001C000000000011100000C00000000100CCCC1
10000000010000000000010100000000000000000CCCC1
1000000001C00000000001010000000000C000101CCCC1
1111111111111111111111111111111111111111111111
