11111111111111111111111
1000011000C0100011000C1
101C00000000100000C0001
101100000C0010C11100001
1010000100001001C001101
10100010001P10010000001
10100010000100000000001
101C0010000E10000111111
101100000001111011C0001
1C000100000000000000001
11111111111111111111111
