1111111111111111111111111111111111111111111111
1P000000000000C0000000000000000000000C00000001
1111111111111111111111111111111111111111111101
1000000000000000000000000000000000000000000001
1011111111111111111111111111111111111111111111
1000000C0000000000000000000000000000C000000001
1111111111111111111111111111111111111111111101
1000000000000000000000000000000000000000000001
1011111111111111111111111111111111111111111111
10000000000000C0000000000000000000000000000001
1111111111111111111111111111111111111111111101
10000000000000000000000000000000000C0000000001
1011111111111111111111111111111111111111111111
1000000C00000000000000000000000000000000000001
1111111111111111111111111111111111111111111101
1000000000000000000000000000000000000000000001
1011111111111111111111111111111111111111111111
100000000000000000C000000000000000000000C00001
1111111111111111111111111111111111111111111101
1E00000000000000000000000000000000000000000001
1111111111111111111111111111111111111111111111
